..............................................................................
..............................................................................
..............................................................................
..............................................................................
..............................................................................
..............................................................................
.......******************...********************....*******************.......
.......*..............................*......................*................
.......*..............................*......................*................
.......******************.............*......................*................
.......*..............................*......................*................
.......*..............................*......................*................
.......*..............................*......................*................
.......*..............................*......................*................
.......*..............................*......................*................
.......*......................*****************..............*................
..............................................................................
..............................................................................
..............................................................................
..............................................................................
..............................................................................
..............................................................................

